EA ./pars/assets/EA.xpm
NO ./pars/assets/NO.xpm
WE ./pars/assets/WE.xpm

F 2, 5, 41
C 50, 150, 150

        111111111111111111111111
        110N00110000001      10011
SO ./pars/assets/WE.xpm
        100000010000001      10001
        100000010000001      10001
        111111111111111111111111111