EA ./pars/assets/EA.xpm
NO ./pars/assets/NO.xpm
WE ./pars/assets/WE.xpm

C 50, 150, 150

F 2, 5, 41

SO ./pars/assets/WE.xpm


















































        11111111111111111111111111
        110S00110000001      10011
        100000010000001      10001
        100000010000001      10001
        111111111111111111111111111



